1111111111111
1001000C00001
1000011111111
10P00000EC001
1111111111111