11111111111111111
10010000000C00001
100001111100C0001
100011E0000000CP1
11111111111111111