11111111111111111111111111111111
10000111011111111111100000000111
10000010001111110110000000001111
10000100000111100010000000001111
10000000000011000000000000101111
1000000P000110000000100000001111
10000100000111000001100000000111
10001100010011100011110000000C11
1101110011101110E111111000C00001
11111100011010000111111100000001
11111000001000000011111110000001
111100000C0000C00001111111100001
11111000000000000011111111000001
11111100011000000111111111100001
11111111111111111111111111111111